00000000000000000000000000000000000000000000000000000000E0000000000000000000
000000000NS0000000000000000000000NSNNN00000000000000000PP0000000000000000000
OOOPOOOOOPPPPPPPP0P0P0P0PPP00PPP0PPPPPP0000000000000000000000000000000000000
0000000000000000000000000000000000000PPPP0PPPPP0PPPPPP0000000000000000000000
0000E000000NNNN0000000000000000000000000000000000000000000000000000000000000
PPPPPPPPPPPPPPPPPPPPPPPPPPPPPPPPPPPPPP00000000000000000000000000000000000000
